00000000
0www0000
00000000
0gg00000
0gg00000
00000000
000ffff0
00000000